1111111111111
1E110000000C1
1000011111001
1P10111000001
1111111111111
