1111111111111111
1CEC000CC000CCC1
1001C00000001001
10000001E0000001
10P0100010000001
1111111111111111