1111111111111
1X1X0000000C1
10000111110X1
1P10111E00001
1111111111111
