1111111111111111
1CEC000CC000CCC1
100XC0000000X001
1000000XE0000001
10P0X000X0000001
1111111111111111
